222222222222222222222
222222222222222222222
111111111111111111111
1    0           0  1
101 1 1 1 1 1 1 1 1 1
1   00000       0   1
1 1 1 1 1 10101 1 1 1
1  0    0     0  0  1
1 1 1 1 1 1 1 1 1 1 1
1  000      0    0  1
1 1 101 1 1 1 1 1 1 1
1   00    00        1
111111111111111111111