2222222222222222222222222222222
1111111111111111111111111111111
1         000       00     0  1
1 1 101 1 101 1 1 101 1 1 1 1 1
10   0     0   0    0    0   01
1 101 1 1 1 101 1 1 101 1 1 1 1
1   0     00      0       000 1
1 1 101 1 1 1 1 101 1 1 1 1 1 1
1       000      0          0 1
1 1 1 1 1 1 1 1 1 1 1 101 101 1
1     0          0        0   1
101 1 101 1 101 1 1 1 1 101 1 1
1       0          0  00      1
1111111111111111111111111111111