2222222222222222222222222222222 
1111111111111111111111111111111
1      00 0  b 0 o 0  0 0 0   1
1 1 1 101 1 10101 1 1 1010101 1
1  00  0  000  0  b   0 0 0 0 1
1 1 1 1 1 101 1 10101 1 1 1 101
10           00  0  0   b     1
1 1 1 1 1 1 1 1 1 101 101 1 1 1
10  0  0   0 0       0        1
1 1 1 1 101 1 1 10101 1 1 1 1 1
10  00    0       0      o    1
1 101 1 1 1 1 1 101 1 1 1 1 1 1
1    d      0   0  0          1
1111111111111111111111111111111