2222222222222222222222222222222
1111111111111111111111111111111
1         000       00     0  1
1 1 101 1 101 1 1 101 1o1 1 1 1
10   0     0   0    0    0   01
1 101 1 1 1 101 1 1 101 1 1 1 1
1   0     00  b   0       000 1
1 1 101 1 1 1o1 10101 1 1 1 1 1
1       000      0      b   0 1
1 1d1 1 1 1 1 1 1 1 1 101 101 1
1     0     b    0        0   1
101 1 101 1 101 1 1 1 1 101 1 1
1  d    0    b     0  00      1
1111111111111111111111111111111