2222222222222222222222222222222
1111111111111111111111111111111
1         000       00    o0  1
1 1 101 1 101d1 1 101 1 1 1 1 1
10   0     0   b    0    0   01
1 101 1 1 1 101 1 1 101 1 1 1 1
1   0     00      0      o000 1
1 1 101 1 1 1 1 101 1 1 1b1 1 1
1  b    000      0     d    0 1
1 1 1 1 1 1 1 1 1 1 1 101 101 1
1     0     o    0        0   1
101 1 101 1 101 1 1 1 1 101 1 1
1  d    0  b       0  00      1
1111111111111111111111111111111