333333333333333333333
333333333333333333333
111111111111111111111
122222222222222222221
121212121012121212121
120222222222222222021
121212121212121212121
122222222222202222221
121212121212121212121
122222222202222222221
121212121212121212121
122222202222222222221
111111111111111111111