333333333333333333333
333333333333333333333
111111111111111111111
122222222222222222221
121212121212121212121
122222222222222222221
121212121212121212121
122222222222222222221
121212121212121212121
122222222222222222221
121212121212121212121
122222222222222222221
111111111111111111111